100 370 60 30  2
130 340 60 30 -1
130 400 60 30 -1
160 370 60 30 -1
160 310 60 30  2
160 430 60 30 -1
190 280 60 30 -1
190 340 60 30 -1
190 400 60 30 -1
190 460 60 30 -1
220 250 60 30 -1
220 310 60 30 -1
220 370 60 30  2
220 430 60 30 -1
220 490 60 30 -1